R 1920 1080

SO ./textures/so.xpm

WE ./textures/we.xpm

NO ./textures/no.xpm

EA ./textures/ea.xpm

S ./textures/s.xpm

F 0,0,0
C 255,255,255


111111
100101
102001
110011
111111
        1111111111111111111111111
        1000000000110000000000001
        1011000001110000002010001
        10010000000000000001 1001
111111111011000001110000000010001
100000000011000001110111110111111
1111011111111101110000001121
11110111111111011101010111011
11000000110101011100010010001
102020000000000000001 1000001
10200000000000000101010010001
11000001110101011 11101110N01
11110111 1110101 101111010001
11111111 1111111 11111111111
