R 1920 1080 

SO ./textures/so.xpm

WE ./textures/we.xpm

NO ./textures/no.xpm

EA ./textures/ea.xpm

S ./textures/s.xpm
F 111,111,111
C 0,0,255

111111
100101
102001
110011
111111
        1111111111111111111111111
        1000000000110000000000001
        1011000001110000002010001
        10000000000000000001 1001
111111111000000001110000000010001
100000000000000001110111110111111
11110000001110111000000112111  1
111100000000110111000001100001
1100000000010101110000000000001
10202000000000000000000000020001
1020000000000000010101000000001
11000001110101011 11101100W0001
11110111 1110101 10111101000111
11111111 1111111 111111111111