R 1920 1080

SO ./textures/so.xpm

WE ./textures/we.xpm

NO ./textures/no.xpm

EA ./textures/ea.xpm

S ./textures/s.xpm

F 0, 0, 0

C 255, 255, 255

111111
100101
102001
110011
111111
        1111111111111111111111111
        1000000000110000000000001
        1011000001110000002000001
        1001000000000000000000001
111111111011000001110000000000001
100000000011000001110111111111111
11110111111111011100000010001
11110111111111011101010010001
11000000110101011100000010001
10202000000000000000000000001
10200000000000000101010010001
11000001110101011 11101110S01
11110111 1110101 101111010001
11111111 1111111 11111111111
