R 30 30

SO ./textures/so.xpm

WE ./textures/we.xpm

NO ./textures/no.xpm

EA ./textures/ea.xpm

S ./textures/s.xpm
F 0,0,255
C 111,111,111


111111
100101
102001
110011
111111
        1111111111111111111111111
        1000000000110000000000001
        1011000001110000002010001
        10010000000000000001 1001
111111111011000001110000000010001
100000000011000001110111110111111
111101111111110111000000112111
1111011111111101110101011000001
1100000011010101110001000000001
10202000000000000000100000020001
1020000000000000010101000000001
11000001110101011 11101100W0001
11110111 1110101 10111101000111
11111111 1111111 11111111111
