R 1920 1080

SO ./textures/so.xpm

WE ./textures/we.xpm

NO ./textures/no.xpm

EA ./textures/ea.xpm

S ./textures/s.xpm
F 111,111,111
C 0,0,255

111111
100101
102001
110011
111111
        1111111111111111111111111
        1000000000110000000000001
        1011000001110000002010001
        10000000000000000001 1001
111111111000000001110000000010001
100000000000000001110111110111101
111111111111111111111111111111111
111100000011101110000001121111
1111000000001101110000011000011
11000000000101011100000000000011
10202000000000000000000000020001
10200000000000000101010002222011
11000011110101011111101100E00001
11111101 1110101 101111010001111
11111111 l1111111111111111111111